1111111111111
10C100000CCC1
1CECP11111CC1
10C0111000001
1111111111111
