11111
1PC01
10111
10CE1
11111
