1111111111
10E000P001
100C00C001
1111111111
100000C001
10C0000001
10000C00C1
1111111111
